111111
100001
1C0P01
1000C1
100E01
111111