111111
1P0001
1CE001
1000M1
100M01
111111